0 0 0 0 0 0 0 0 0 0 0 0 0 0 0 0 0 0 0 0 0 0 0 0 0 0 0 0 0 0 0 0 0 0 0 0 0 0 0 0 
0 0 0 0 0 0 0 0 0 0 0 0 0 0 0 0 0 0 0 0 0 0 0 0 0 0 0 0 0 0 0 0 0 0 0 0 0 0 0 0 
0 0 0 0 0 0 0 0 0 0 0 0 0 0 0 0 0 0 0 0 0 0 0 0 0 0 0 0 0 0 0 0 0 0 0 0 0 0 0 0 
172 173 174 175 0 0 0 0 0 0 0 0 0 0 0 0 0 0 0 0 0 0 0 0 0 0 0 0 0 0 0 0 0 0 0 0 172 173 174 175 
191 192 193 194 109 109 109 109 109 109 109 109 109 109 109 109 109 109 0 0 0 109 109 109 109 109 109 109 109 109 109 109 109 109 109 109 191 192 193 194 
210 211 212 213 109 0 0 0 0 0 0 0 0 0 0 0 0 0 0 0 0 0 0 0 0 0 0 0 0 0 0 0 0 0 0 109 210 211 212 213 
191 192 193 194 109 0 0 0 0 0 0 0 0 0 0 0 0 0 0 0 0 0 0 0 0 0 0 0 0 0 0 0 0 0 0 109 191 192 193 194 
210 211 212 213 109 0 0 0 0 0 0 0 0 0 0 0 0 0 0 0 0 0 0 0 0 0 0 0 0 0 0 0 0 0 0 109 210 211 212 213 
191 192 193 194 109 0 0 0 109 109 109 109 0 0 0 0 0 0 0 0 0 0 0 0 0 0 0 109 109 109 109 0 0 0 0 109 191 192 193 194 
210 211 212 213 109 0 0 0 109 109 109 109 0 0 0 0 0 0 0 0 0 0 0 0 0 0 0 109 109 109 109 0 0 0 0 109 210 211 212 213 
191 192 193 194 109 0 0 0 109 109 0 0 0 0 0 0 0 0 0 0 0 0 0 0 0 0 0 0 0 109 109 0 0 0 0 109 191 192 193 194 
210 211 212 213 109 0 0 0 109 109 0 0 0 0 0 0 0 0 0 0 0 0 0 0 0 0 0 0 0 109 109 0 0 0 0 109 210 211 212 213 
191 192 193 194 109 0 0 0 0 0 0 0 0 0 0 0 0 0 0 0 0 0 0 0 0 0 0 0 0 0 0 0 0 0 0 109 191 192 193 194 
210 211 212 213 109 0 0 0 0 0 0 0 0 0 0 0 0 0 0 0 0 0 0 0 0 0 0 0 0 0 0 0 0 0 0 109 210 211 212 213 
191 192 193 194 109 0 0 0 0 0 0 0 0 0 0 0 0 0 0 0 0 0 0 0 0 0 0 0 0 0 0 0 0 0 0 109 191 192 193 194 
210 211 212 213 109 0 0 0 0 0 0 0 0 0 0 0 0 0 0 0 0 0 0 0 0 0 0 0 0 0 0 0 0 0 0 109 210 211 212 213 
191 192 193 194 109 0 0 0 0 0 0 0 0 0 0 0 0 0 0 0 0 0 0 0 0 0 0 0 0 0 0 0 0 0 0 109 191 192 193 194 
210 211 212 213 109 0 0 0 0 0 0 0 0 0 0 0 0 0 0 0 0 0 0 0 0 0 0 0 0 0 0 0 0 0 0 109 210 211 212 213 
191 192 193 194 0 0 0 0 0 0 0 0 0 0 0 0 0 0 0 0 0 0 0 0 0 0 0 0 0 0 0 0 0 0 0 0 191 192 193 194 
210 211 212 213 0 0 0 0 0 0 0 0 0 0 0 0 0 0 0 0 0 0 0 0 0 0 0 0 0 0 0 0 0 0 0 0 210 211 212 213 
191 192 193 194 0 0 0 0 0 0 0 0 0 0 0 0 0 0 0 0 0 0 0 0 0 0 0 0 0 0 0 0 0 0 0 0 191 192 193 194 
210 211 212 213 109 0 0 0 0 0 0 0 0 0 0 0 0 0 0 0 0 0 0 0 0 0 0 0 0 0 0 0 0 0 0 109 210 211 212 213 
191 192 193 194 109 0 0 0 0 0 0 0 0 0 0 0 0 0 0 0 0 0 0 0 0 0 0 0 0 0 0 0 0 0 0 109 191 192 193 194 
210 211 212 213 109 0 0 0 0 0 0 0 0 0 0 0 0 0 0 0 0 0 0 0 0 0 0 0 0 0 0 0 0 0 0 109 210 211 212 213 
191 192 193 194 109 0 0 0 0 0 0 0 0 0 0 0 0 0 0 0 0 0 0 0 0 0 0 0 0 0 0 0 0 0 0 109 191 192 193 194 
210 211 212 213 109 0 0 0 0 0 0 0 0 0 0 0 0 0 0 0 0 0 0 0 0 0 0 0 0 0 0 0 0 0 0 109 210 211 212 213 
191 192 193 194 109 0 0 0 0 0 0 0 0 0 0 0 0 0 0 0 0 0 0 0 0 0 0 0 0 0 0 0 0 0 0 109 191 192 193 194 
210 211 212 213 109 0 0 0 109 109 0 0 0 0 0 0 0 0 0 0 0 0 0 0 0 0 0 0 0 109 109 0 0 0 0 109 210 211 212 213 
191 192 193 194 109 0 0 0 109 109 0 0 0 0 0 0 0 0 0 0 0 0 0 0 0 0 0 0 0 109 109 0 0 0 0 109 191 192 193 194 
210 211 212 213 109 0 0 0 109 109 109 109 0 0 0 0 0 0 0 0 0 0 0 0 0 0 0 109 109 109 109 0 0 0 0 109 210 211 212 213 
191 192 193 194 109 0 0 0 109 109 109 109 0 0 0 0 0 0 0 0 0 0 0 0 0 0 0 109 109 109 109 0 0 0 0 109 191 192 193 194 
210 211 212 213 109 0 0 0 0 0 0 0 0 0 0 0 0 0 0 0 0 0 0 0 0 0 0 0 0 0 0 0 0 0 0 109 210 211 212 213 
191 192 193 194 109 0 0 0 0 0 0 0 0 0 0 0 0 0 0 0 0 0 0 0 0 0 0 0 0 0 0 0 0 0 0 109 191 192 193 194 
210 211 212 213 109 0 0 0 0 0 0 0 0 0 0 0 0 0 0 0 0 0 0 0 0 0 0 0 0 0 0 0 0 0 0 109 210 211 212 213 
191 192 193 194 109 0 0 0 0 0 0 0 0 0 0 0 0 0 0 0 0 0 0 0 0 0 0 0 0 0 0 0 0 0 0 109 191 192 193 194 
210 211 212 213 109 109 109 109 109 109 109 109 109 109 109 109 109 109 0 0 0 109 109 109 109 109 109 109 109 109 109 109 109 109 109 109 210 211 212 213 
210 211 212 213 0 0 0 0 0 0 0 0 0 0 0 0 0 0 0 0 0 0 0 0 0 0 0 0 0 0 0 0 0 0 0 0 210 211 212 213 
0 0 0 0 0 0 0 0 0 0 0 0 0 0 0 0 0 0 0 0 0 0 0 0 0 0 0 0 0 0 0 0 0 0 0 0 0 0 0 0 
0 0 0 0 0 0 0 0 0 0 0 0 0 0 0 0 0 0 0 0 0 0 0 0 0 0 0 0 0 0 0 0 0 0 0 0 0 0 0 0 
0 0 0 0 0 0 0 0 0 0 0 0 0 0 0 0 0 0 0 0 0 0 0 0 0 0 0 0 0 0 0 0 0 0 0 0 0 0 0 0
0 0 0 0 0 0 0 0 0 0 0 0 0 0 0 0 0 0 0 0 0 0 0 0 0 0 0 0 0 0 0 0 0 0 0 0 0 0 0 0 
0 0 0 0 0 0 0 0 0 0 0 0 0 0 0 0 0 0 0 0 0 0 0 0 0 0 0 0 0 0 0 0 0 0 0 0 0 0 0 0 
0 0 0 0 0 0 0 0 0 0 0 0 0 0 0 0 0 0 0 0 0 0 0 0 0 0 0 0 0 0 0 0 0 0 0 0 0 0 0 0 
