40 45
57 57 57 57 57 57 57 57 57 57 57 57 57 57 57 57 57 57 57 57 57 57 57 57 57 57 57 57 57 57 57 57 57 57 57 57 57 57 57 57 
57 81 81 81 81 81 81 81 81 81 81 81 81 81 81 81 81 81 81 81 81 81 81 81 81 81 81 81 81 81 81 81 81 81 81 81 81 81 81 57 
57 81 81 81 81 81 81 81 81 81 81 81 81 81 81 81 81 81 81 81 81 81 81 81 81 81 81 81 81 81 81 81 81 81 81 81 81 81 81 57 
57 81 81 81 81 81 81 81 81 81 81 81 81 81 81 81 81 81 81 81 81 81 81 81 81 81 81 81 81 81 81 81 81 81 81 81 81 81 81 57 
57 81 81 81 57 57 57 57 57 57 57 57 57 57 57 57 57 57 57 57 57 57 57 57 57 57 57 57 57 57 57 57 57 57 57 57 81 81 81 57 
57 81 81 81 57 57 57 57 57 57 57 57 57 57 57 57 57 57 57 57 57 57 57 57 57 57 57 57 57 57 57 57 57 57 57 57 81 81 81 57 
57 81 81 81 57 57 57 57 57 57 57 57 57 57 57 57 57 57 57 57 57 57 57 57 57 57 57 57 57 57 57 57 57 57 57 57 81 81 81 57 
57 81 81 81 57 57 57 57 57 57 57 57 57 57 57 57 57 57 57 57 57 57 57 57 57 57 57 57 57 57 57 57 57 57 57 57 81 81 81 57 
57 81 81 81 57 57 57 57 57 57 57 57 57 57 57 57 57 57 57 57 57 57 57 57 57 57 57 57 57 57 57 57 57 57 57 57 81 81 81 57 
57 81 81 81 57 57 57 57 57 57 57 57 57 57 57 57 57 57 57 57 57 57 57 57 57 57 57 57 57 57 57 57 57 57 57 57 81 81 81 57 
57 81 81 81 57 57 57 57 57 57 81 81 81 57 57 57 57 57 57 57 57 57 57 57 57 57 81 81 81 57 57 57 57 57 57 57 81 81 81 57 
57 81 81 81 57 57 57 57 57 57 81 81 81 57 57 57 57 57 57 57 57 57 57 57 57 57 81 81 81 57 57 57 57 57 57 57 81 81 81 57 
57 81 81 81 57 57 57 57 57 57 81 81 81 57 57 57 57 57 57 57 57 57 57 57 57 57 81 81 81 57 57 57 57 57 57 57 81 81 81 57 
57 81 81 81 57 57 57 57 57 57 57 57 57 57 57 57 57 57 57 57 57 57 57 57 57 57 57 57 57 57 57 57 57 57 57 57 81 81 81 57 
57 81 81 81 57 57 57 57 57 57 57 57 57 57 81 81 81 57 57 57 57 57 81 81 81 57 57 57 57 57 57 57 57 57 57 57 81 81 81 57 
57 81 81 81 57 57 57 57 57 57 57 57 57 57 81 81 81 57 57 57 57 57 81 81 81 57 57 57 57 57 57 57 57 57 57 57 81 81 81 57 
57 81 81 81 57 57 57 57 57 57 57 57 57 57 81 81 81 57 57 57 57 57 81 81 81 57 57 57 57 57 57 57 57 57 57 57 81 81 81 57 
57 81 81 81 57 57 57 57 57 57 57 57 57 57 57 57 57 57 57 57 57 57 57 57 57 57 57 57 57 57 57 57 57 57 57 57 81 81 81 57 
57 81 81 81 57 57 57 57 57 57 57 57 57 57 57 57 57 57 57 57 57 57 57 57 57 57 57 57 57 57 57 57 57 57 57 57 81 81 81 57 
57 81 81 81 57 57 57 57 57 57 57 57 57 57 57 57 57 57 57 57 57 57 57 57 57 57 57 57 57 57 57 57 57 57 57 57 81 81 81 57 
57 81 81 81 57 57 57 57 57 57 57 57 57 57 57 57 57 57 57 57 57 57 57 57 57 57 57 57 57 57 57 57 57 57 57 57 81 81 81 57 
57 81 81 81 57 57 57 57 57 57 57 57 57 57 57 57 57 57 57 57 57 57 57 57 57 57 57 57 57 57 57 57 57 57 57 57 81 81 81 57 
57 81 81 81 57 57 57 57 57 57 57 57 57 57 81 81 81 57 57 57 57 57 81 81 81 57 57 57 57 57 57 57 57 57 57 57 81 81 81 57 
57 81 81 81 57 57 57 57 57 57 57 57 57 57 81 81 81 57 57 57 57 57 81 81 81 57 57 57 57 57 57 57 57 57 57 57 81 81 81 57 
57 81 81 81 57 57 57 57 57 57 57 57 57 57 81 81 81 57 57 57 57 57 81 81 81 57 57 57 57 57 57 57 57 57 57 57 81 81 81 57 
57 81 81 81 57 57 57 57 57 57 57 57 57 57 57 57 57 57 57 57 57 57 57 57 57 57 57 57 57 57 57 57 57 57 57 57 81 81 81 57 
57 81 81 81 57 57 57 57 57 57 81 81 81 57 57 57 57 57 57 57 57 57 57 57 57 57 81 81 81 57 57 57 57 57 57 57 81 81 81 57 
57 81 81 81 57 57 57 57 57 57 81 81 81 57 57 57 57 57 57 57 57 57 57 57 57 57 81 81 81 57 57 57 57 57 57 57 81 81 81 57 
57 81 81 81 57 57 57 57 57 57 81 81 81 57 57 57 57 57 57 57 57 57 57 57 57 57 81 81 81 57 57 57 57 57 57 57 81 81 81 57 
57 81 81 81 57 57 57 57 57 57 57 57 57 57 57 57 57 57 57 57 57 57 57 57 57 57 57 57 57 57 57 57 57 57 57 57 81 81 81 57 
57 81 81 81 57 57 57 57 57 57 57 57 57 57 57 57 57 57 57 57 57 57 57 57 57 57 57 57 57 57 57 57 57 57 57 57 81 81 81 57 
57 81 81 81 57 57 57 57 57 57 57 57 57 57 57 57 57 57 57 57 57 57 57 57 57 57 57 57 57 57 57 57 57 57 57 57 81 81 81 57 
57 81 81 81 57 57 57 57 57 57 57 57 57 57 57 57 57 57 57 57 57 57 57 57 57 57 57 57 57 57 57 57 57 57 57 57 81 81 81 57 
57 81 81 81 57 57 57 57 57 57 57 57 57 57 57 57 57 57 57 57 57 57 57 57 57 57 57 57 57 57 57 57 57 57 57 57 81 81 81 57 
57 81 81 81 57 57 57 57 57 57 57 57 57 57 57 57 57 57 57 57 57 57 57 57 57 57 57 57 57 57 57 57 57 57 57 57 81 81 81 57 
57 81 81 81 57 57 57 57 57 57 57 57 57 57 57 57 57 57 57 57 57 57 57 57 57 57 57 57 57 57 57 57 57 57 57 57 81 81 81 57 
57 81 81 81 57 57 57 57 57 57 57 57 57 57 57 57 57 57 57 57 57 57 57 57 57 57 57 57 57 57 57 57 57 57 57 57 81 81 81 57 
57 81 81 81 81 81 81 81 81 81 81 81 81 81 81 81 81 81 81 81 81 81 81 81 81 81 81 81 81 81 81 81 81 81 81 81 81 81 81 57 
57 81 81 81 81 81 81 81 81 81 81 81 81 81 81 81 81 81 81 81 81 81 81 81 81 81 81 81 81 81 81 81 81 81 81 81 81 81 81 57 
57 81 81 81 81 81 81 81 81 81 81 81 81 81 81 81 81 81 81 81 81 81 81 81 81 81 81 81 81 81 81 81 81 81 81 81 81 81 81 57
57 81 81 81 81 81 81 81 81 81 81 81 81 81 81 81 81 81 81 81 81 81 81 81 81 81 81 81 81 81 81 81 81 81 81 81 81 81 81 57
57 81 81 81 81 81 81 81 81 81 81 81 81 81 81 81 81 81 81 81 81 81 81 81 81 81 81 81 81 81 81 81 81 81 81 81 81 81 81 57
57 81 81 81 81 81 81 81 81 81 81 81 81 81 81 81 81 81 81 81 81 81 81 81 81 81 81 81 81 81 81 81 81 81 81 81 81 81 81 57
57 81 81 81 81 81 81 81 81 81 81 81 81 81 81 81 81 81 81 81 81 81 81 81 81 81 81 81 81 81 81 81 81 81 81 81 81 81 81 57
57 57 57 57 57 57 57 57 57 57 57 57 57 57 57 57 57 57 57 57 57 57 57 57 57 57 57 57 57 57 57 57 57 57 57 57 57 57 57 57