40 56
55 55 55 55 55 55 55 55 55 55 55 55 55 55 55 55 55 55 55 55 55 55 55 55 55 55 55 55 55 55 55 55 55 55 55 55 55 55 55 55
55 55 55 55 55 55 55 55 55 55 55 55 55 55 55 55 55 55 55 42 55 55 55 55 55 55 55 55 55 55 55 55 55 55 55 55 55 55 55 55
55 55 55 55 55 55 55 55 55 55 55 55 55 55 55 55 55 55 42 42 42 55 55 55 55 55 55 55 55 55 55 55 55 55 55 55 55 55 55 55
55 55 55 55 55 55 55 55 55 55 55 55 55 55 55 55 55 42 42 42 42 42 55 55 55 55 55 55 55 55 55 55 55 55 55 55 55 55 55 55
55 55 55 55 55 55 55 55 55 55 55 55 55 55 55 55 42 42 42 42 42 42 42 55 55 55 55 55 55 55 55 55 55 55 55 55 55 55 55 55
55 55 55 55 55 55 55 55 55 55 55 55 55 55 55 42 42 42 42 45 42 42 42 42 55 55 55 55 55 55 55 55 55 55 55 55 55 55 55 55
55 55 55 55 55 55 55 55 55 55 55 55 55 55 42 42 42 42 42 46 42 42 42 42 42 55 55 55 55 55 55 55 55 55 55 55 55 55 55 55
55 55 55 55 55 55 55 55 55 55 55 55 55 55 42 42 42 45 42 42 42 45 42 42 42 55 55 55 55 55 55 55 55 55 55 55 55 55 55 55
55 55 55 55 55 55 55 55 55 55 55 55 55 55 42 42 42 46 42 42 42 46 42 42 42 55 55 55 55 55 55 55 55 55 55 55 55 55 55 55
55 55 55 55 55 55 55 55 55 55 55 55 55 55 42 42 42 42 42 42 42 42 42 42 42 55 55 55 55 55 55 55 55 55 55 55 55 55 55 55
55 55 55 55 55 55 55 55 55 55 55 55 55 55 41 41 41 41 41 41 41 41 41 41 41 55 55 55 55 55 55 55 55 55 55 55 55 55 55 55
55 55 55 55 55 55 55 55 55 55 55 55 55 55 41 41 41 41 41 41 41 41 41 41 41 55 55 55 55 55 55 55 55 55 55 55 55 55 55 55
55 55 55 55 55 55 55 55 55 55 55 55 55 55 41 41 41 41 41 41 41 41 41 41 41 55 55 55 55 55 55 55 55 55 55 55 55 55 55 55
55 55 55 55 55 55 55 55 55 55 55 55 55 55 41 41 41 41 41 41 41 41 41 41 41 55 55 55 55 55 55 55 55 55 55 55 55 55 55 55
55 42 42 42 42 42 42 42 42 42 42 42 42 42 41 41 41 41 49 50 51 41 41 41 41 42 42 42 42 42 42 42 42 42 42 42 42 42 55 55
55 42 42 42 45 42 42 42 42 45 42 42 42 42 41 41 41 41 52 53 54 41 41 41 41 42 42 42 42 45 42 42 42 42 45 42 42 42 55 55
55 42 42 42 46 42 42 42 42 46 42 42 42 42 47 47 47 47 48 61 62 47 47 47 47 42 42 42 42 46 42 42 42 42 46 42 42 42 55 55
55 42 42 42 42 42 42 42 42 42 42 42 42 42 41 41 41 41 52 53 54 41 41 41 41 42 42 42 42 42 42 42 42 42 42 42 42 42 55 55
55 40 40 40 40 40 40 40 40 40 40 40 40 40 41 41 41 41 52 53 54 41 41 41 41 40 40 40 40 40 40 40 40 40 40 40 40 40 55 55
55 40 40 40 40 40 40 40 40 40 40 40 40 40 41 41 41 41 52 53 54 41 41 41 41 40 40 40 40 40 40 40 40 40 40 40 40 40 55 55
55 40 40 40 40 40 40 40 40 40 40 40 40 40 41 41 41 41 52 53 54 41 41 41 41 40 40 40 40 40 40 40 40 40 40 40 40 40 55 55
55 40 40 40 40 40 40 40 40 40 40 40 40 40 41 41 41 41 52 53 54 41 41 41 41 40 40 40 40 40 40 40 40 40 40 40 40 40 55 55
55 40 40 40 40 40 40 40 40 40 40 40 40 40 41 41 41 41 52 53 54 41 41 41 41 40 40 40 40 40 40 40 40 40 40 40 40 40 55 55
55 40 40 40 40 40 40 40 40 40 40 40 40 40 41 41 41 41 52 53 54 41 41 41 41 40 40 40 40 40 40 40 40 40 40 40 40 40 55 55
55 40 40 40 40 40 40 40 40 40 40 40 40 40 41 41 41 41 52 53 54 41 41 41 41 40 40 40 40 40 40 40 40 40 40 40 40 40 55 55
55 40 40 40 40 40 40 40 40 40 40 40 40 40 41 41 41 41 52 53 54 41 41 41 41 40 40 40 40 40 40 40 40 40 40 40 40 40 55 55
55 40 40 40 40 40 40 40 40 40 40 40 40 40 41 41 41 41 52 53 54 41 41 41 41 40 40 40 40 40 40 40 40 40 40 40 40 40 55 55
55 40 40 40 40 40 40 40 40 40 40 40 40 40 41 41 41 41 52 53 54 41 41 41 41 40 40 40 40 40 40 40 40 40 40 40 40 40 55 55
55 40 40 40 40 40 40 40 40 40 40 40 40 40 41 41 41 41 52 53 54 41 41 41 41 40 40 40 40 40 40 40 40 40 40 40 40 40 55 55
55 40 40 40 40 40 40 40 40 40 40 40 40 40 41 41 41 41 52 53 54 41 41 41 41 40 40 40 40 40 40 40 40 40 40 40 40 40 55 55
55 40 40 40 40 40 40 40 40 40 40 40 40 40 41 41 41 41 52 53 54 41 41 41 41 40 40 40 40 40 40 40 40 40 40 40 40 40 55 55
55 40 40 40 40 40 40 40 40 40 40 40 40 40 41 41 41 41 52 53 54 41 41 41 41 40 40 40 40 40 40 40 40 40 40 40 40 40 55 55
55 40 40 40 40 40 40 40 40 40 40 40 40 40 41 41 41 41 52 53 54 41 41 41 41 40 40 40 40 40 40 40 40 40 40 40 40 40 55 55
55 40 40 40 40 40 40 40 40 40 40 40 40 40 41 41 41 41 52 53 54 41 41 41 41 40 40 40 40 40 40 40 40 40 40 40 40 40 55 55
55 40 40 40 40 40 40 40 40 40 40 40 40 40 41 41 41 41 52 53 54 41 41 41 41 40 40 40 40 40 40 40 40 40 40 40 40 40 55 55
55 40 40 40 40 40 40 40 40 40 40 40 40 40 41 41 41 41 52 53 54 41 41 41 41 40 40 40 40 40 40 40 40 40 40 40 40 40 55 55
55 40 40 40 40 40 40 40 40 40 40 40 40 40 41 41 41 41 52 53 54 41 41 41 41 40 40 40 40 40 40 40 40 40 40 40 40 40 55 55
55 40 40 40 40 40 40 40 40 40 40 40 40 40 41 41 41 41 52 53 54 41 41 41 41 40 40 40 40 40 40 40 40 40 40 40 40 40 55 55
55 40 40 40 40 40 40 40 40 40 40 40 40 40 41 41 41 41 52 53 54 41 41 41 41 40 40 40 40 40 40 40 40 40 40 40 40 40 55 55
55 40 40 40 40 40 40 40 40 40 40 40 40 40 41 41 41 41 52 53 54 41 41 41 41 40 40 40 40 40 40 40 40 40 40 40 40 40 55 55
55 40 40 40 40 40 40 40 40 40 40 40 40 40 41 41 41 41 52 53 54 41 41 41 41 40 40 40 40 40 40 40 40 40 40 40 40 40 55 55
55 40 40 40 40 40 40 40 40 40 40 40 40 40 41 41 41 41 52 53 54 41 41 41 41 40 40 40 40 40 40 40 40 40 40 40 40 40 55 55
55 40 40 40 40 40 40 40 40 40 40 40 40 40 41 41 41 41 52 53 54 41 41 41 41 40 40 40 40 40 40 40 40 40 40 40 40 40 55 55
55 40 40 40 40 40 40 40 40 40 40 40 40 40 41 41 41 41 52 53 54 41 41 41 41 40 40 40 40 40 40 40 40 40 40 40 40 40 55 55
55 40 40 40 40 40 40 40 40 40 40 40 40 40 41 41 41 41 52 53 54 41 41 41 41 40 40 40 40 40 40 40 40 40 40 40 40 40 55 55
55 40 40 40 40 40 40 40 40 40 40 40 40 40 41 41 41 41 52 53 54 41 41 41 41 40 40 40 40 40 40 40 40 40 40 40 40 40 55 55
55 40 40 40 40 40 40 40 40 40 40 40 40 40 41 41 41 41 52 53 54 41 41 41 41 40 40 40 40 40 40 40 40 40 40 40 40 40 55 55
55 40 40 40 40 40 40 40 40 40 40 40 40 40 41 41 41 41 52 53 54 41 41 41 41 40 40 40 40 40 40 40 40 40 40 40 40 40 55 55
55 40 40 40 40 40 40 40 40 40 40 40 40 40 41 41 41 41 52 53 54 41 41 41 41 40 40 40 40 40 40 40 40 40 40 40 40 40 55 55
55 55 55 55 55 55 55 55 55 55 55 55 55 55 55 55 55 55 55 55 55 55 55 55 55 55 55 55 55 55 55 55 55 55 55 55 55 55 55 55
55 55 55 55 55 55 55 55 55 55 55 55 55 55 55 55 55 55 55 55 55 55 55 55 55 55 55 55 55 55 55 55 55 55 55 55 55 55 55 55
55 55 55 55 55 55 55 55 55 55 55 55 55 55 55 55 55 55 55 55 55 55 55 55 55 55 55 55 55 55 55 55 55 55 55 55 55 55 55 55
55 55 55 55 55 55 55 55 55 55 55 55 55 55 55 55 55 55 55 55 55 55 55 55 55 55 55 55 55 55 55 55 55 55 55 55 55 55 55 55
55 55 55 55 55 55 55 55 55 55 55 55 55 55 55 55 55 55 55 55 55 55 55 55 55 55 55 55 55 55 55 55 55 55 55 55 55 55 55 55
55 55 55 55 55 55 55 55 55 55 55 55 55 55 55 55 55 55 55 55 55 55 55 55 55 55 55 55 55 55 55 55 55 55 55 55 55 55 55 55
55 55 55 55 55 55 55 55 55 55 55 55 55 55 55 55 55 55 55 55 55 55 55 55 55 55 55 55 55 55 55 55 55 55 55 55 55 55 55 55

